5 5
1 2 3 4 5
1 2 3 4 5
4 3 2 1 5
0 0 0 1 2
0 1 4 2 3
